4000,99999,1,1,1,4,0,0,
4,0,0,15,30,100,9,9,
5,0,0,100,200,100,2,5,
7,0,0,150,300,100,5,8,
8,0,700,200,450,100,5,8,
12,0,1800,450,750,100,1,1,
20,1,0,1,1,100,0,0,
23,0,13500,13500,13500,100,9,9,
0,0,0,0,0,0,0,9,
0,0,0,0,0,0,0,9,
0,0,0,0,0,0,0,9,
0,0,0,0,0,0,0,9,
0,0,0,0,0,0,0,9,
0,0,0,0,0,0,0,9,
0,0,0,0,0,0,0,9,
0,0,0,0,0,0,0,9,
0,0,0,0,0,0,0,9,
0,0,0,0,0,0,0,9,
0,0,0,0,0,0,0,9,
0,0,0,0,0,0,0,9,
0,0,0,0,0,0,0,9,
