4800,20000,15,30,3,10,0,0,
17,20,0,10,15,100,0,9,
14,1,0,1,1,99,0,0,
17,0,0,50,150,99,6,9,
14,2,1500,1500,2000,100,0,3,
6,0,0,600,900,99,1,6,
16,0,0,300,600,99,1,6,
24,1,0,1,1,90,0,0,
23,0,13500,13500,13500,100,9,9,
0,0,0,0,0,0,0,9,
0,0,0,0,0,0,0,9,
0,0,0,0,0,0,0,9,
0,0,0,0,0,0,0,9,
0,0,0,0,0,0,0,9,
0,0,0,0,0,0,0,9,
0,0,0,0,0,0,0,9,
0,0,0,0,0,0,0,9,
0,0,0,0,0,0,0,9,
0,0,0,0,0,0,0,9,
0,0,0,0,0,0,0,9,
0,0,0,0,0,0,0,9,
