4800,12000,15,60,0,4,0,0,
3,0,0,15,150,100,0,9,
3,0,0,15,150,100,0,9,
4,0,0,15,150,100,0,9,
9,0,0,15,150,100,0,4,
7,1,0,1,1,100,5,5,
8,2,0,1,30,80,5,9,
8,2,0,1,30,70,5,9,
8,2,0,1,30,60,5,9,
23,0,13500,13500,13500,100,9,9,
0,0,0,0,0,0,0,9,
0,0,0,0,0,0,0,9,
0,0,0,0,0,0,0,9,
0,0,0,0,0,0,0,9,
0,0,0,0,0,0,0,9,
0,0,0,0,0,0,0,9,
0,0,0,0,0,0,0,9,
0,0,0,0,0,0,0,9,
0,0,0,0,0,0,0,9,
0,0,0,0,0,0,0,9,
0,0,0,0,0,0,0,9,
