4800,15000,2,150,3,8,0,0,
2,0,0,50,200,100,0,9,
3,0,150,75,100,100,0,9,
4,0,300,100,150,100,0,9,
15,0,600,150,300,100,0,9,
8,0,2400,450,900,100,3,9,
10,0,3000,450,900,100,0,1,
7,0,1200,450,900,100,3,9,
5,0,1800,450,900,100,1,3,
6,0,1800,450,900,100,1,3,
23,0,13500,13500,13500,100,9,9,
0,0,0,0,0,0,0,9,
0,0,0,0,0,0,0,9,
0,0,0,0,0,0,0,9,
0,0,0,0,0,0,0,9,
0,0,0,0,0,0,0,9,
0,0,0,0,0,0,0,9,
0,0,0,0,0,0,0,9,
0,0,0,0,0,0,0,9,
0,0,0,0,0,0,0,9,
0,0,0,0,0,0,0,9,
