6000,100000,1,1,3,20,0,0,
17,0,0,150,300,100,1,9,
12,2,0,1,1,99,0,9,
12,8,0,30,60,99,0,9,
18,1,0,1,1,90,0,0,
24,1,0,1,1,90,1,1,
24,1,0,1,1,90,8,8,
4,0,0,15,30,90,2,9,
19,1,0,1,1,85,0,0,
17,0,0,15,30,60,2,9,
19,1,0,1,1,60,0,0,
19,1,0,1,1,60,7,7,
20,1,0,1,1,60,1,1,
18,1,0,1,1,10,0,0,
23,0,13500,13500,13500,100,9,9,
0,0,0,0,0,0,0,9,
0,0,0,0,0,0,0,9,
0,0,0,0,0,0,0,9,
0,0,0,0,0,0,0,9,
0,0,0,0,0,0,0,9,
0,0,0,0,0,0,0,9,
