4800,18000,1,30,0,10,0,0,
2,0,0,50,450,100,1,9,
3,0,150,150,300,100,1,9,
4,0,300,150,150,100,1,9,
15,0,600,150,600,100,1,9,
4,0,0,1,15,90,1,9,
4,20,0,1,1,90,1,9,
11,1,0,1,1,90,0,0,
23,0,13500,13500,13500,100,9,9,
0,0,0,0,0,0,0,9,
0,0,0,0,0,0,0,9,
0,0,0,0,0,0,0,9,
0,0,0,0,0,0,0,9,
0,0,0,0,0,0,0,9,
0,0,0,0,0,0,0,9,
0,0,0,0,0,0,0,9,
0,0,0,0,0,0,0,9,
0,0,0,0,0,0,0,9,
0,0,0,0,0,0,0,9,
0,0,0,0,0,0,0,9,
0,0,0,0,0,0,0,9,
