4800,2400,2,60,2,6,0,0,
2,0,0,160,280,100,1,6,
3,0,0,300,800,100,1,6,
4,0,600,300,800,100,6,9,
4,6,0,30,60,90,6,9,
5,1,0,15,30,90,0,0,
23,0,13500,13500,13500,100,9,9,
0,0,0,0,0,0,0,9,
0,0,0,0,0,0,0,9,
0,0,0,0,0,0,0,9,
0,0,0,0,0,0,0,9,
0,0,0,0,0,0,0,9,
0,0,0,0,0,0,0,9,
0,0,0,0,0,0,0,9,
0,0,0,0,0,0,0,9,
0,0,0,0,0,0,0,9,
0,0,0,0,0,0,0,9,
0,0,0,0,0,0,0,9,
0,0,0,0,0,0,0,9,
0,0,0,0,0,0,0,9,
0,0,0,0,0,0,0,9,
